####################
#..................#
#.@................#
#..................#
#........E.........#
#....r.............#
#.................B#
#.................b#
#......H...........#
#.................e#
#.................h#
####################
